NO ./ghorayr/respawn_anchor_side3.xpm
SO ./ghorayr/respawn_anchor_side2.xpm
WE ./ghorayr/respawn_anchor_side1.xpm
EA ./ghorayr/respawn_anchor_side0.xpm

F 0,0,0
C 10,255,150




1111111111111111111111111111111111
1111111110110001001110000000000001
11111000000000010000000000000000001011111111
1000000000110S01000000000000000011111
111100000111000100000000000000001111
100000000011000100111011111111111
1111000000000001111000000100000001
1111000000000001111010100100000001
1100000011010101111000000000011111
100000000000000101100000010000001
100000000000000101101010000000011
11000001110101011111101100000111
1111011101110101101000000000000
11111111111111111111111111111111