NO ghorayr/images.xpm
SO ghorayr/img2.xpm
WE ghorayr/img4.xpm
EA ghorayr/img5.xpm

F 0,0,0
C 10,255,150


111111111111111111111111111111111
111111111011000001110000000000001
100100000000000000000000000000111
1000000000110S0000000000000000001001
101100000111000000000000000000001
100000000011000001110111111111111
111100000000000111000000100000001
111100000000000111010100100000001
110000001101010111000000000011111
10000000000000001100000010000001
10000000000000001101010000000011
1100000111010101111101100000111
1111011101110101010000000000001
1111111111111111111111111111111