NO ghorayr/respawn_anchor_side0.xpm
SO ghorayr/respawn_anchor_side1.xpm
WE ghorayr/respawn_anchor_side2.xpm
EA ghorayr/respawn_anchor_side3.xpm

F 0,0,0
C 10,255,150


111     
111111111011000001110000000000001
1001000000000000000000000000001
1000000000110S0000000000000000001
101100000111000000000000000000001
100000000011000001110111111111111
111100000000000111000000100000001
111100000000000111010100100000001
11000000110101011100000000001
10000000000000001100000010000001
1000000000000000110101000000001
1100000111010101111101100000111
1111011101110101010000000000001
111111111111111 111111111111