NO                                      ./path_to_the_north_texture
SO ./path_to_the_south_texture
WE ./path_to_the_west_texture
EA ./path_to_the_east_texture


F 220,100,0
C 225,30,0


111
111111111011000001110000000000001
100100000000000000000000000000001
100000000011000000000000000000001
101100000111000000000000000000001
100000000011000001110111111111111
111100000000000111000000100000001
111100000000000111010100100000001
11000000110101011100000000001
10000000000000001100000010000001
1000000000000000110101000000001
11000001110101011111011000N0111
1111011101110101010000000000001
111111111111111 111111111111