NO ./ghorayr/soul_sand.xpm
SO ./ghorayr/soul_sand.xpm
WE ./ghorayr/soul_sand.xpm
EA ./ghorayr/soul_sand.xpm

F 200,90,119
C 135,206,235

0111111111111111111
1001100000100000011
100110000010000001
1111100111100100011
100110001010000N011
1001100001100000011
1001100000100000011
1001100000000000011
1001100000100000011
1111111111111111111
