NO ./ghorayr/img99.xpm
SO ./ghorayr/img2.xpm
WE ./ghorayr/img4.xpm

F 65,90,119
C 135,206,235

1111	111111111111111
1001	100000100000011
1001	10000010000001
1111	100111100100011
1001	10001010000N011
1001	100001100000011
1001	100000100000011
1001	100000000000011
1001	100000100000011
1111	111111111111111
